/study1/coverage/results//chr1.DP.bcf	/study1/subset_normalize/results/chr1.subset.bcf	/study1/annotate/result/vep/chr1.subset.bcf.vep.vcf.gz
/study1/coverage/results//chr2.DP.bcf	/study1/subset_normalize/results/chr2.subset.bcf	/study1/annotate/result/vep/chr2.subset.bcf.vep.vcf.gz
/study1/coverage/results//chr3.DP.bcf	/study1/subset_normalize/results/chr3.subset.bcf	/study1/annotate/result/vep/chr3.subset.bcf.vep.vcf.gz
/study1/coverage/results//chr4.DP.bcf	/study1/subset_normalize/results/chr4.subset.bcf	/study1/annotate/result/vep/chr4.subset.bcf.vep.vcf.gz
/study1/coverage/results//chr5.DP.bcf	/study1/subset_normalize/results/chr5.subset.bcf	/study1/annotate/result/vep/chr5.subset.bcf.vep.vcf.gz
/study1/coverage/results//chr6.DP.bcf	/study1/subset_normalize/results/chr6.subset.bcf	/study1/annotate/result/vep/chr6.subset.bcf.vep.vcf.gz
/study1/coverage/results//chr7.DP.bcf	/study1/subset_normalize/results/chr7.subset.bcf	/study1/annotate/result/vep/chr7.subset.bcf.vep.vcf.gz
/study1/coverage/results//chr8.DP.bcf	/study1/subset_normalize/results/chr8.subset.bcf	/study1/annotate/result/vep/chr8.subset.bcf.vep.vcf.gz
/study1/coverage/results//chr9.DP.bcf	/study1/subset_normalize/results/chr9.subset.bcf	/study1/annotate/result/vep/chr9.subset.bcf.vep.vcf.gz
/study1/coverage/results//chr10.DP.bcf	/study1/subset_normalize/results/chr10.subset.bcf	/study1/annotate/result/vep/chr10.subset.bcf.vep.vcf.gz
/study1/coverage/results//chr11.DP.bcf	/study1/subset_normalize/results/chr11.subset.bcf	/study1/annotate/result/vep/chr11.subset.bcf.vep.vcf.gz
/study1/coverage/results//chr12.DP.bcf	/study1/subset_normalize/results/chr12.subset.bcf	/study1/annotate/result/vep/chr12.subset.bcf.vep.vcf.gz
/study1/coverage/results//chr13.DP.bcf	/study1/subset_normalize/results/chr13.subset.bcf	/study1/annotate/result/vep/chr13.subset.bcf.vep.vcf.gz
/study1/coverage/results//chr14.DP.bcf	/study1/subset_normalize/results/chr14.subset.bcf	/study1/annotate/result/vep/chr14.subset.bcf.vep.vcf.gz
/study1/coverage/results//chr15.DP.bcf	/study1/subset_normalize/results/chr15.subset.bcf	/study1/annotate/result/vep/chr15.subset.bcf.vep.vcf.gz
/study1/coverage/results//chr16.DP.bcf	/study1/subset_normalize/results/chr16.subset.bcf	/study1/annotate/result/vep/chr16.subset.bcf.vep.vcf.gz
/study1/coverage/results//chr17.DP.bcf	/study1/subset_normalize/results/chr17.subset.bcf	/study1/annotate/result/vep/chr17.subset.bcf.vep.vcf.gz
/study1/coverage/results//chr18.DP.bcf	/study1/subset_normalize/results/chr18.subset.bcf	/study1/annotate/result/vep/chr18.subset.bcf.vep.vcf.gz
/study1/coverage/results//chr19.DP.bcf	/study1/subset_normalize/results/chr19.subset.bcf	/study1/annotate/result/vep/chr19.subset.bcf.vep.vcf.gz
/study1/coverage/results//chr20.DP.bcf	/study1/subset_normalize/results/chr20.subset.bcf	/study1/annotate/result/vep/chr20.subset.bcf.vep.vcf.gz
/study1/coverage/results//chr21.DP.bcf	/study1/subset_normalize/results/chr21.subset.bcf	/study1/annotate/result/vep/chr21.subset.bcf.vep.vcf.gz
/study1/coverage/results//chr22.DP.bcf	/study1/subset_normalize/results/chr22.subset.bcf	/study1/annotate/result/vep/chr22.subset.bcf.vep.vcf.gz
/study1/coverage/results//chrX.DP.bcf	/study1/subset_normalize/results/chrX.subset.bcf	/study1/annotate/result/vep/chrX.subset.bcf.vep.vcf.gz
